###############################################################
#S        #                           #########################
######### # ######################### #                 #######
######### # ######################### # ####### ####### #######
######### # ######################### # ####### ####### #######
######### # ###                  #### # ####### ####### #######
######### # ### ################ #### #  ###### ####### #######
######### # ### ################ #### ## ######         #######
######### #  ## #        ####### #### ## ############## #######
#         # # # # ###### ####### #### ##       ########      ##
######### # # # # ## ### ####### #### ### #### ######## #######
##    ### # # # # ## ### ####### #### ###          #### #######
## ###### #     #    ###     ### ####     ############# #######
## ###### ####### ###### ### ### ###################### #######
#                 ###### ### ### ###################### #######
######################## ### ### ###################### #######
######                   ### ### ####                   #######
###### ################# ###  ## #### #########################
###### #################         ####                      E###
###############################################################
